0,6
6,6
b b b w b b b b
b b b w b b b b
b w b w b w b b
b w b w b w b b
b w b w b w b b
b w b w b w b b
b w b b b w b b
b w b b b w b b