0,7
6,1
h b b b b b b b
b b h b b b b b
b b b b b b b b
h b b h b b b h
b b b b b b b b
b b b b b h b h
b b b b b b b b
b b b b b b h b